NO texture/l.xpm
SO texture/d.xpm
WE texture/r.xpm
EA texture/u.xpm
F 00,		00,		255
C     255,   00,		150

11111111111111111111111111
1000000000000000000000001
1000000000000000000000001
1100000000000000000000001
111000000000000000000000111
  1000000000000000000000001
111000000000000000001000111
1111111000000000000000001
1000000000000000010000001
1000000000000010000000001
1000000000000000000000001
10000000000001N0000000001
1000000000000000000000001
1111111111111111111111111